1 4 4 4 2 2 2 2 2 2 2 2 2 2 2 5
1 0 0 0 0 0 0 0 0 0 0 0 0 0 0 5
1 0 0 0 0 0 0 0 0 0 0 0 0 0 0 5
1 0 0 0 0 0 0 0 0 0 0 0 0 0 0 5
1 0 0 0 0 0 0 0 0 0 0 0 0 0 0 5
1 0 0 0 0 0 0 0 0 0 0 0 0 0 0 5
1 0 0 0 0 0 0 0 0 0 0 0 0 0 0 5
1 0 0 0 0 0 0 0 0 0 0 0 0 0 0 5
1 0 0 0 0 0 0 0 0 0 0 0 0 0 0 5
1 0 0 0 0 2 2 2 2 2 2 2 0 0 0 5
1 0 0 0 0 2 2 2 2 2 2 2 0 0 0 5
1 0 0 0 0 2 2 2 2 2 2 2 0 0 0 5